亜: つぐ
哀: あわれ、あわれむ、かなしい
愛: いとしい、かなしい、めでる、おしむ、まな
挨: ひらく
悪: わるい、あし、にくい、ああ、いずくに、いずくんぞ、にくむ
握: にぎる
圧: おす、へす、おさえる、おさえる
扱: あつかい、あつかう、あつかる、こく
宛: あてる、あたかも
安: やすい、やすまる、やす、やすらか
暗: くらい、くらむ、くれる
案: つくえ
闇: やみ、くらい
以: もって
位: くらい、ぐらい
依: よる
偉: えらい
囲: かこむ、かこう、かこい
委: ゆだねる
威: おどす、おどし、おどかす
慰: なぐさめる、なぐさむ
易: やさしい、やすい
為: ため、なる、なす、する、たり、つくる、なり
畏: おそれる、かしこまる、かしこ、かしこし
異: こと、ことなる、け
移: うつる、うつす
緯: よこいと、ぬき
萎: な、しおれる、しなびる、しぼむ、なえる
衣: ころも、きぬ
違: ちがう、ちがい、ちがえる、たがう、たがえる
遺: のこす
医: いやす、いする、くすし
井: い
育: そだつ、そだち、そだてる、はぐくむ
一: ひとつ
壱: ひとつ
逸: それる、そらす、はぐれる
稲: いね
茨: いばら、かや、くさぶき
芋: いも
印: しるし、しるす
咽: むせぶ、むせる、のど、のむ
因: よる、ちなむ
引: ひく、ひける
飲: のむ
淫: ひたす、ほしいまま、みだら、みだれる、みだり
陰: かげ、かげる
隠: かくす、かくし、かくれる、よる
右: みぎ
羽: は、わ、はね
雨: あめ
臼: うす、うすづく
渦: うず
唄: うた、うたう
浦: うら
運: はこぶ
雲: くも
餌: え、えば、えさ、もち
営: いとなむ、いとなみ
影: かげ
映: うつる、うつす、はえる
栄: さかえる、はえ、はえる、え
永: ながい
泳: およぐ
英: はなぶさ
詠: よむ、うたう
鋭: するどい
益: ます
悦: よろこぶ、よろこばす
越: こす、こえる
閲: けみする
円: まるい、まる、まど、まどか、まろやか
園: その
宴: うたげ
延: のびる、のべる、のべ、のばす
怨: うらむ、うらみ、うらめしい
沿: そう
炎: ほのお
煙: けむる、けむり、けむい
猿: さる
縁: ふち、ふちどる、ゆかり、よすが、へり、えにし
艶: つや、なまめかしい、あでやか、つやめく、なまめく
遠: とおい
鉛: なまり
塩: しお
汚: けがす、けがれる、けがらわしい、よごす、よごれる、きたない
凹: くぼむ、へこむ、ぼこ
奥: おく、おくまる、くま
往: いく、いにしえ、さきに、ゆく
応: あたる、まさに、こたえる
押: おす、おさえる、おさえる
旺: かがやき、うつくしい、さかん
横: よこ
欧: うたう、はく
殴: なぐる
翁: おきな
黄: き
岡: おか
沖: おき、おきつ、ちゅうする、わく
屋: や
臆: むね、おくする
乙: きのと
俺: おれ、われ
卸: おろす、おろし、おろし
温: あたたか、あたたかい、あたたまる、あたためる、ぬく
穏: おだやか
音: おと、ね
下: した、しも、もと、さげる、さがる、くだる、くだり、くだす、くださる、おろす、おりる
化: ばける、ばかす、ふける、けする
仮: かり
何: なに、なん
価: あたい
加: くわえる、くわわる
夏: なつ
嫁: よめ、とつぐ、いく、ゆく
家: いえ、や、うち
暇: ひま、いとま
果: はたす、はたす、はてる、はて
架: かける、かかる
歌: うた、うたう
河: かわ
火: ひ
禍: わざわい
稼: かせぐ
花: はな
苛: いじめる、さいなむ、いらだつ、からい、こまかい
荷: に
華: はな
貨: たから
過: すぎる、すごす、あやまち、あやまつ、よぎる、よぎる
蚊: か
我: われ、わ
牙: きば、は
画: えがく、かくする、かぎる、はかりごと、はかる
芽: め
雅: みやび
餓: うえる
会: あう、あわせる、あつまる
解: とく、とかす、とける、ほどく、ほどける、わかる、さとる
回: まわる、まわす、もとおる、かえる
塊: かたまり、つちくれ
壊: こわす、こわれる、やぶる
快: こころよい
怪: あやしい、あやしむ
悔: くいる、くやむ、くやしい
懐: ふところ、なつかしい、なつかしむ、なつく、なつける、なずける、いだく、おもう
戒: いましめる
改: あらためる、あらたまる
械: かせ
海: うみ
灰: はい
皆: みな、みんな
開: ひらく、ひらき、ひらける、あく、あける
階: きざはし
貝: かい
外: そと、ほか、はずす、はずれる
崖: がけ、きし、はて
慨: なげく
概: おおむね
涯: はて
蓋: ふた、けだし、おおう、かさ、かこう
街: まち
骸: むくろ
垣: かき
柿: かき
嚇: おどす
各: おのおの
拡: ひろがる、ひろげる、ひろめる
殻: から、がら
獲: える
確: たしか、たしかめる
覚: おぼえる、さます、さめる、さとる
角: かど、つの
較: くらべる
郭: くるわ
隔: へだてる、へだたる
革: かわ
学: まなぶ
岳: たけ
楽: たのしい、たのしむ、このむ
額: ひたい
顎: あご、あぎと
掛: かける、かけ、かかる、かかり、かかり
潟: かた
割: わる、わり、わり、われる、さく
括: くくる
活: いきる、いかす、いける
渇: かわく
滑: すべる、なめらか
葛: つづら、くず
轄: くさび
且: かつ
株: かぶ
釜: かま
鎌: かま
刈: かる
瓦: かわら、ぐらむ
乾: かわく、かわかす、ほす、ひる、いぬい
冠: かんむり
寒: さむい
勧: すすめる
巻: まく、まき、まき
喚: わめく
堪: たえる、たまる、こらえる、こたえる
寛: くつろぐ、ひろい、ゆるやか
干: ほす、ひる
幹: みき
患: わずらう
慣: なれる、ならす
憾: うらむ
換: かえる、かわる
敢: あえて、あえない、あえず
歓: よろこぶ
汗: あせ
環: わ
甘: あまい、あまえる、あまやかす、うまい
看: みる
管: くだ
簡: えらぶ、ふだ
緩: ゆるい、ゆるやか、ゆるむ、ゆるめる
缶: かま
肝: きも
観: みる、しめす
貫: つらぬく、ぬく、ぬき
還: かえる
鑑: かんがみる、かがみ
間: あいだ、ま、あい
関: せき、かかわる、からくり、かんぬき
陥: おちいる、おとしいれる
韓: から、いげた
館: やかた、たて
丸: まる、まるめる、まるい
含: ふくむ、ふくめる
岸: きし
玩: もちあそぶ、もてあそぶ
眼: まなこ、め
岩: いわ
頑: かたく
顔: かお
願: ねがう
企: くわだてる、たくらむ
伎: わざ、わざおぎ
危: あぶない、あやうい、あやぶむ
喜: よろこぶ、よろこばす
器: うつわ
基: もと、もとい
奇: くしき、あやしい、くし、めずらしい
寄: よる、よせる
希: まれ、こいねがう
幾: いくつ、いくら
忌: いむ、いみ、いまわしい
揮: ふるう
机: つくえ
旗: はた
既: すでに
棋: ご
棄: すてる
機: はた
帰: かえる、かえす、おくる、とつぐ
気: き
畿: みやこ
祈: いのる
記: しるす
貴: たっとい、とうとい、たっとぶ、とうとぶ
起: おきる、おこる、おこす、おこす、たつ
輝: かがやく
飢: うえる
鬼: おに
亀: かめ
偽: いつわる、にせ、いつわり
宜: よろしい、よろしく
戯: たわむれる、ざれる、じゃれる
技: わざ
擬: まがい、もどき
欺: あざむく
犠: いけにえ
疑: うたがう
吉: よし
喫: のむ
詰: つめる、つめ、つまる、つむ
却: かえって、しりぞく、しりぞける
脚: あし
虐: しいたげる
逆: さか、さかさ、さからう
丘: おか
久: ひさしい
休: やすむ、やすまる、やすめる
及: およぶ、および、および、およぼす
吸: すう
宮: みや
弓: ゆみ
急: いそぐ、いそぎ、せく
救: すくう
朽: くちる
求: もとめる
泣: なく
球: たま
究: きわめる
窮: きわめる、きわまる、きわまり、きわみ
糾: ただす
給: たまう、たもう
旧: ふるい、もと
牛: うし
去: さる
居: いる、おる
拒: こばむ
拠: よる
挙: あげる、あがる、こぞる
虚: むなしい、うつろ
許: ゆるす、もと
距: へだたる、けづめ
漁: あさる
魚: うお、さかな
享: うける
京: みやこ
供: そなえる、とも
競: きそう、せる、くらべる
共: とも、ともに
叫: さけぶ
境: さかい
峡: はざま
強: つよい、つよまる、つよめる、しいる、こわい
恐: おそれる、おそる、おそろしい、こわい、こわがる
恭: うやうやしい
挟: はさむ、はさまる、わきばさむ、さしはさむ
教: おしえる、おそわる
橋: はし
況: まして、いわんや、おもむき
狂: くるう、くるおしい、くるおしい
狭: せまい、せばめる、せばまる、さ
矯: ためる
胸: むね
脅: おびやかす、おどす、おどかす
興: おこる、おこす
郷: さと
鏡: かがみ
響: ひびく
驚: おどろく、おどろかす
仰: あおぐ、おおせ、おっしゃる、おっしゃる
凝: こる、こらす、こごらす、こごらせる、こごる
暁: あかつき、さとる
業: わざ
局: つぼね
曲: まがる、まげる、くま
極: きわめる、きわまる、きわまり、きわみ、きめる、きまる
玉: たま
僅: わずか
勤: つとめる、つとまる、いそしむ
均: ならす
巾: おおい、ちきり、きれ
錦: にしき
琴: こと
筋: すじ
緊: しめる、しまる
襟: えり
謹: つつしむ
近: ちかい
金: かね
銀: しろがね
九: ここの、ここのつ
苦: くるしい、くるしむ、くるしめる、にがい、にがる
駆: かける、かる
駒: こま
具: そなえる、つぶさに
愚: おろか
虞: おそれ、おもんぱかる、はかる、うれえる、あざむく、あやまる、のぞむ、たのしむ
空: そら、あく、あき、あける、から、すく、すかす、むなしい
偶: たま
遇: あう
隅: すみ
串: くし、つらぬく
屈: かがむ、かがめる
掘: ほる
窟: いわや、いはや、あな
靴: くつ
熊: くま
繰: くる
桑: くわ
勲: いさお
君: きみ
薫: かおる
訓: おしえる、よむ、くんずる
群: むれる、むれ、むら、むらがる
軍: いくさ
郡: こおり
係: かかる、かかり、かかわる
傾: かたむく、かたむける、かたぶく、かたげる、かしげる
兄: あに
啓: ひらく、さとす
型: かた
契: ちぎる
形: かた、かたち、なり
径: みち、こみち、さしわたし、ただちに
恵: めぐむ、めぐみ
慶: よろこび
憩: いこい、いこう
掲: かかげる
携: たずさえる、たずさわる
敬: うやまう
渓: たに、たにがわ
稽: かんがえる、とどめる
経: へる、たつ、たていと、はかる、のり
継: つぐ
茎: くき
蛍: ほたる
計: はかる、はからう
詣: けいする、まいる、いたる、もうでる
警: いましめる
軽: かるい、かろやか、かろんじる
鶏: にわとり、とり
芸: うえる、のり、わざ
迎: むかえる
鯨: くじら
撃: うつ
激: はげしい
隙: すき、すく、すかす、ひま
桁: けた
傑: すぐれる
欠: かける、かく
決: きめる、きまる、さく
潔: いさぎよい
穴: あな
結: むすぶ、ゆう、ゆわえる
血: ち
月: つき
件: くだん
倹: つましい、つづまやか
健: すこやか
兼: かねる
剣: つるぎ
圏: かこい
堅: かたい
嫌: きらう、きらい、いや
建: たてる、たて、たつ
懸: かける、かかる
拳: こぶし
検: しらべる
権: おもり、かり、はかる
犬: いぬ
献: たてまつる
研: とぐ
絹: きぬ
県: かける
肩: かた
見: みる、みえる、みせる
謙: へりくだる
賢: かしこい
軒: のき
遣: つかう、つかわす、やる
鍵: かぎ
険: けわしい
顕: あきらか、あらわれる
験: あかし、しるし、ためす、ためし
元: もと
原: はら
厳: おごそか、きびしい、いかめしい、いつくし
幻: まぼろし
弦: つる
減: へる、へらす
源: みなもと
玄: くろ、くろい
現: あらわれる、あらわす、うつつ、うつつ
舷: ふなばた、ふなべり
言: いう、こと
限: かぎる、かぎり
古: ふるい
呼: よぶ
固: かためる、かたまる、かたまり、かたい
己: おのれ、つちのと、な
庫: くら
戸: と
故: ゆえ、ふるい、もと
枯: かれる、からす
湖: みずうみ
股: また、もも
虎: とら
誇: ほこる
雇: やとう
顧: かえりみる
鼓: つづみ
五: いつ、いつつ
互: たがい、かたみに
午: うま
呉: くれる、くれ
後: のち、うしろ、うしろ、あと、おくれる
悟: さとる
語: かたる、かたらう
誤: あやまる
護: まもる
乞: こう
交: まじわる、まじえる、まじる、まじる、まざる、まぜる、かわす、かわす、こもごも
候: そうろう
光: ひかる、ひかり
公: おおやけ
功: いさお
効: きく、ききめ、ならう
勾: かぎ、まがる
厚: あつい、あか
口: くち
向: むく、むい、むける、むかう、むかい、むこう、むこ、むかい
后: きさき
喉: のど
好: このむ、すく、よい、いい
孔: あな
巧: たくみ、たくむ、うまい
幸: さいわい、さち、しあわせ
広: ひろい、ひろまる、ひろめる、ひろがる、ひろげる
恒: つね、つねに
慌: あわてる、あわただしい
抗: あらがう
拘: かかわる
控: ひかえる、ひかえ
攻: せめる
更: さら、さらに、ふける、ふかす
梗: ふさぐ、やまにれ、おおむね
構: かまえる、かまう
江: え
港: みなと
溝: みぞ
甲: きのえ
硬: かたい
稿: わら、したがき
紅: べに、くれない、あかい
絞: しぼる、しめる、しまる
綱: つな
耕: たがやす
考: かんがえる、かんがえ
肯: がえんじる
荒: あらす、あれる、あらい、すさぶ、すさむ、あらし
行: いく、ゆく、おこなう、おこなう
貢: みつぐ
鉱: あらがね
鋼: はがね
降: おりる、おろす、ふる、ふり、くだる、くだす
項: うなじ
香: か、かおり、かおる
高: たかい、たか、たかまる、たかめる
号: さけぶ、よびな
合: あう、あい、あわす、あわせる
豪: えらい
克: かつ
刻: きざむ、きざみ
告: つげる
国: くに
酷: ひどい
黒: くろ、くろずむ、くろい
腰: こし
骨: ほね
込: こむ、こみ、こめる
頃: ころ、ごろ、しばらく
今: いま
困: こまる
墾: はる、ひらく
恨: うらむ、うらめしい
懇: ねんごろ
根: ね
混: まじる、まざる、まぜる、こむ
痕: あと
魂: たましい、たま
唆: そそる、そそのかす
左: ひだり
差: さす、さし
沙: すな、よなげる
砂: すな
詐: いつわる
鎖: くさり、とざす
座: すわる
挫: くじく、くじける
催: もようす、もよおす
再: ふたたび
最: もっとも、つま
塞: ふさぐ、とりで、みちる
妻: つま
彩: いろどる
採: とる
歳: とし、とせ、よわい
済: すむ、すまない、すます、すくう、なす、わたし、わたる
災: わざわい
采: とる、いろどり
砕: くだく、くだける
祭: まつる、まつり、まつり
斎: とき、つつしむ、ものいみ、いむ、いわう、いつく
細: ほそい、ほそる、こまか、こまかい
菜: な
裁: たつ、さばく
載: のせる、のる
際: きわ
剤: かる、けずる
在: ある
罪: つみ
財: たから
坂: さか
阪: さか
咲: さく
崎: さき、さい、みさき
埼: さき、さい、みさき
作: つくる、つくり
削: けずる、はつる、そぐ
搾: しぼる
柵: しがらむ、しがらみ、とりで、やらい
桜: さくら
冊: ふみ
刷: する、はく
拶: せまる
撮: とる、つまむ
擦: する、すれる、こする、こすれる
札: ふだ
殺: ころす、そぐ
雑: まじえる、まじる
皿: さら
三: み、みつ、みっつ
傘: かさ
参: まいる、まじわる、みつ
山: やま
惨: みじめ、いたむ、むごい
散: ちる、ちらす、ちらかす、ちらかる、ちらばる、ばら、ばらける
桟: かけはし
産: うむ、うまれる、むす
算: そろ
蚕: かいこ、こ
賛: たすける、たたえる
酸: すい
斬: きる
暫: しばらく
残: のこる、のこす、そこなう、のこり
仕: つかえる
伺: うかがう
使: つかう、つかい
刺: さす、ささる、さし、さし、とげ
司: つかさどる
四: よ、よつ、よっつ、よん
士: さむらい
始: はじめる、はじまる
姉: あね、はは
姿: すがた
子: こ、ね
市: いち
師: いくさ
志: シリング、こころざす、こころざし
思: おもう、おもえらく、おぼす
指: ゆび、さす
支: ささえる、つかえる、かう
施: ほどこす
旨: むね、うまい
枝: えだ
止: とまる、とめる、とどめる、とどめ、とどまる、やめる、やむ、よす
死: しぬ
氏: うじ
私: わたくし、わたし
糸: いと
紙: かみ
紫: むらさき
脂: あぶら
至: いたる
視: みる
詞: ことば
詩: うた
試: こころみる、ためす
諮: はかる
賜: たまわる、たまう、たもう
雌: めす、めん
飼: かう
歯: よわい、は、よわい、よわいする
事: こと、つかう、つかえる
似: にる、ひる
侍: さむらい、はべる
児: こ
字: あざ、あざな
寺: てら
慈: いつくしむ
持: もつ、もてる
時: とき
次: つぐ、つぎ
治: おさめる、おさまる、なおる、なおす
示: しめす
耳: みみ
自: みずから、おのずから、おのずと
辞: やめる、いなむ
鹿: しか、か
識: しる、しるす
七: なな、ななつ、なの
叱: しかる
執: とる
失: うしなう、うせる
嫉: そねむ、ねたむ、にくむ
室: むろ
湿: しめる、しめす、うるおう、うるおす
漆: うるし
疾: はやい
質: たち、ただす、もと、わりふ
実: み、みのる、まこと、みの、みちる
芝: しば
舎: やどる
写: うつす、うつる、うつし
射: いる、さす、うつ
捨: すてる
斜: ななめ、はす
煮: にる、にえる、にやす
社: やしろ
者: もの
謝: あやまる
車: くるま
遮: さえぎる
蛇: へび
邪: よこしま
借: かりる
尺: さし
酌: くむ
釈: とく、すてる、ゆるす
若: わかい、もしくわ、もし、もしくは、ごとし
寂: さび、さびしい、さびれる、さみしい
弱: よわい、よわる、よわまる、よわめる
主: ぬし、おも、あるじ
取: とる、とり、とり
守: まもる、まもり、もり、かみ
手: て
朱: あけ
殊: こと
狩: かる、かり
珠: たま
種: たね
腫: はれる、はれ、はらす、はれもの
趣: おもむき、おもむく
酒: さけ
首: くび
受: うける、うかる
呪: まじなう、のろい、まじない、のろう
寿: ことぶき、ことぶく、ことほぐ
授: さずける、さずかる
樹: き
囚: とらわれる
収: おさめる、おさまる
周: まわり
宗: むね
就: つく、つける
州: す
修: おさめる、おさまる
愁: うれえる、うれい
拾: ひろう
秀: ひいでる
秋: あき、とき
終: おわる、おわる、おえる、つい、ついに
習: ならう、ならい
臭: くさい、におう、におい
舟: ふね
衆: おおい
襲: おそう、かさね
蹴: ける
酬: むくいる
集: あつまる、あつめる、つどう
醜: みにくい、しこ
住: すむ、すまう
充: あてる、みたす
十: とお、と、そ
従: したがう、したがえる、より
柔: やわらか、やわらかい、やわ、やわら
汁: しる、つゆ
渋: しぶ、しぶい、しぶる
獣: けもの、けだもの
縦: たて
重: え、おもい、おもり、おもなう、かさねる、かさなる、おも
銃: つつ
宿: やど、やどる、やどす
淑: しとやか
祝: いわう
縮: ちぢむ、ちぢまる、ちぢめる、ちぢれる、ちぢらす
粛: つつしむ
熟: うれる
出: でる、だす、いでる、いだす
術: すべ
述: のべる
春: はる
瞬: またたく、まじろぐ
準: じゅんじる、じゅんずる、なぞらえる、のり、ひとしい、みずもり
潤: うるおう、うるおす、うるむ
盾: たて
巡: めぐる、めぐり
処: ところ、おる
初: はじめ、はじめて、はつ
所: ところ、どころ、とこ
暑: あつい
緒: お、いとぐち
書: かく
諸: もろ
助: たすける、たすかる、すける、すけ
叙: ついず、ついで
女: おんな、め
序: ついで、ついで
徐: おもむろに
除: のぞく
傷: きず、いたむ、いためる
償: つぐなう
勝: かつ、まさる、すぐれる、かつ
匠: たくみ
升: ます
召: めす
商: あきなう
唱: となえる
奨: すすめる
宵: よい
将: まさに、はた、まさ、ひきいる、もって
小: ちいさい
少: すくない、すこし
尚: なお
床: とこ、ゆか
承: うけたまわる、うける
招: まねく
掌: てのひら、たなごころ
昇: のぼる
松: まつ
沼: ぬま
消: きえる、けす
渉: わたる
焼: やく、やき、やける
焦: こげる、こがす、こがれる、あせる、じれる、じらす
照: てる、てらす、てれる
省: かえりみる、はぶく
祥: さいわい、きざし、よい、つまびらか
称: たたえる、となえる、あげる、かなう、はかり、はかる、ほめる
笑: わらう、えむ
肖: あやかる
衝: つく
証: あかし
詔: みことのり
詳: くわしい、つまびらか
象: かたどる
賞: ほめる
鐘: かね
障: さわる
上: うえ、かみ、あげる、あがる、あがり、のぼる、のぼり、のぼせる、のぼす、たてまつる
丈: たけ、だけ
乗: のる、のせる
剰: あまつさえ、あまり、あまる
城: しろ
場: ば
壌: つち
嬢: むすめ
常: つね
情: なさけ
条: えだ、すじ
浄: きよめる、きよい
畳: たたむ、たたみ、かさなる
蒸: むす、むれる、むらす
譲: ゆずる
醸: かもす
嘱: しょくする、たのむ
飾: かざる、かざり
拭: ぬぐう、ふく
植: うえる、うわる
殖: ふえる、ふやす
織: おる、おり、おり
色: いろ
触: ふれる、さわる、さわ
食: くう、くらう、たべる、はむ
辱: はずかしめる
尻: しり
伸: のびる、のばす、のべる、のす
侵: おかす
唇: くちびる
寝: ねる、ねかす、いぬ、みたまや、やめる
審: つまびらか、つぶさに
心: こころ
慎: つつしむ、つつましい、つつし、つつしみ
振: ふる、ふれる、ふるう
新: あたらしい、あらた
森: もり
浸: ひたす、ひたる、つかる
深: ふかい、ふかまる、ふかめる
申: もうす、さる
真: ま、まこと
神: かみ
薪: たきぎ、まき
親: おや、したしい、したしむ
診: みる
身: み
辛: からい、つらい、かのと
進: すすむ、すすめる
針: はり
震: ふるう、ふるえる、ふるわせる、ふるわす
人: ひと
刃: は、やいば、きる
尋: たずねる、ひろ
甚: はなはだ、はなはだしい
尽: つきる、つくす、つかす、ことごとく
須: すべからく、すべし、ひげ、まつ、もちいる、もとめる
酢: す
図: え、はかる
吹: ふく
垂: たれる、たらす、たれ、なんなんとす
推: おす
水: みず
炊: たく
睡: ねむる、ねむい
粋: いき
衰: おとろえる
遂: とげる、ついに
酔: よう、よい、よ
随: まにまに、したがう
崇: あがめる
数: かず、かぞえる、しばしば、せめる、わずらわしい
枢: とぼそ、からくり
据: すえる、すわる
杉: すぎ
裾: すそ
澄: すむ、すます
世: よ
瀬: せ
畝: せ、うね
是: これ、この、ここ
凄: さむい、すごい、すさまじい
勢: いきおい、はずみ
性: さが
成: なる、なす
政: まつりごと、まん
整: ととのえる、ととのう
星: ほし
晴: はれる、はれ、はらす
正: ただしい、ただす、まさ、まさに
清: きよい、きよまる、きよめる
生: いきる、いかす、いける、うまれる、うまれる、うまれ、うまれ、うむ、おう、はえる、はやす、き、なま、なる、なす、むす
盛: もる、さかる、さかん
精: しらげる、くわしい
聖: ひじり
声: こえ
西: にし
誠: まこと
誓: ちかう
請: こう、うける
逝: ゆく、いく
醒: さます、さめる
青: あお、あおい
静: しずか、しずまる、しずめる
斉: そろう、ひとしい、ひとしく、あたる、はやい
席: むしろ
惜: おしい、おしむ
戚: いたむ、うれえる、みうち
斥: しりぞける
昔: むかし
石: いし
積: つむ、つもる、つもり
脊: せ、せい
責: せめる
赤: あか、あかい、あからむ、あからめる
跡: あと
切: きる、きり、きれる、きれ
拙: つたない
接: つぐ
摂: おさめる、かねる、とる
折: おる、おり、おり、おれる
設: もうける
窃: ぬすむ、ひそか
節: ふし、のっと
説: とく
雪: ゆき
絶: たえる、たやす、たつ
舌: した
先: さき、まず
千: ち
占: しめる、うらなう
宣: のたまう
専: もっぱら
川: かわ
戦: いくさ、たたかう、おののく、そよぐ、わななく
扇: おうぎ
泉: いずみ
浅: あさい
洗: あらう
染: そめる、そまる、しみる、しみ
潜: ひそむ、もぐる、かくれる、くぐる、ひそめる
煎: せんじる、いる、にる
旋: めぐる、いばり
線: すじ
羨: うらやむ、あまり
船: ふね
薦: すすめる
詮: せんずる、かい、あきらか
践: ふむ
選: えらぶ、える、よる
遷: うつる、うつす、みやこがえ
銭: ぜに、すき
鮮: あざやか
前: まえ
善: よい、いい、よく、よしとする
漸: ようやく、やや、ようよう、すすむ
然: しか、しかり、しかし、さ
全: まったく、すべて
禅: しずか、ゆずる
繕: つくろう
膳: かしわ、すすめる、そなえる
塑: でく
措: おく
曽: かつ、かつて、すなわち
狙: ねらう、ねらい
疎: うとい、うとむ、まばら
礎: いしずえ
粗: あらい
素: もと
組: くむ、くみ
訴: うったえる
阻: はばむ
遡: さかのぼる
創: つくる、はじめる、きず、けずしける
双: ふた、たぐい、ならぶ、ふたつ
倉: くら
喪: も
壮: さかん
奏: かなでる
爽: あきらか、さわやか、たがう
想: おもう
捜: さがす
掃: はく
挿: さす、はさむ
操: みさお、あやつる
早: はやい、はや、はやまる、はやめる
巣: す、すくう
槽: ふね
燥: はしゃぐ
争: あらそう、いかでか
痩: やせる
窓: まど、てんまど、けむだし
総: すべて、すべて、ふさ
草: くさ
荘: ほうき、おごそか
葬: ほうむる
藻: も
装: よそおう、よそおい
走: はしる
送: おくる
遭: あう、あわせる
霜: しも
騒: さわぐ、うれい、さわがしい
増: ます、まし、ふえる、ふやす
憎: にくむ、にくい、にくらしい、にくしみ
臓: はらわた
蔵: くら、おさめる、かくれる
贈: おくる
造: つくる、つくり
促: うながす
側: かわ、がわ、そば
則: のっとる、のり、すなわち
即: つく、つける、すなわち
息: いき
捉: とらえる
束: たば、たばねる、つか、つかねる
測: はかる
足: あし、たりる、たる、たす
速: はやい、はやめる、すみやか
属: さかん、つく、やから
続: つづく、つづける、つぐない
卒: そっする、おえる、おわる、ついに、にわか
袖: そで
存: ながらえる、ある、たもつ、とう
孫: まご
尊: たっとい、とうとい、たっとぶ、とうとぶ
損: そこなう、そこなう、そこねる
村: むら
遜: したがう、へりくだる、ゆずる
他: ほか
多: おおい、まさに、まさる
太: ふとい、ふとる
汰: おごる、にごる、よなげる
唾: つば、つばき
堕: おちる、くずす、くずれる
打: うつ、ぶつ
体: からだ、かたち
堆: うずたかい
対: あいて、こたえる、そろい、つれあい、ならぶ、むかう
耐: たえる
帯: おびる、おび
待: まつ
怠: おこたる、なまける
態: わざと
戴: いただく
替: かえる、かわる
滞: とどこおる
袋: ふくろ
貸: かす
退: しりぞく、しりぞける、ひく、のく、のける、どく
代: かわる、かわる、かわり、かわり、かえる、よ、しろ
台: うてな、われ、つかさ
大: おおきい
滝: たき
択: えらぶ
拓: ひらく
沢: さわ、うるおい、うるおす、つや
濯: すすぐ、ゆすぐ
託: かこつける、かこつ、かこつける
濁: にごる、にごす
但: ただし
奪: うばう
脱: ぬぐ、ぬげる
棚: たな
谷: たに、きわまる
誰: だれ、たれ、た
丹: に
単: ひとえ
嘆: なげく、なげかわしい
担: かつぐ、になう
探: さぐる、さがす
旦: あきらか、あきら、ただし、あさ、あした
淡: あわい
炭: すみ
短: みじかい
端: はし、は、はた、はな
綻: ほころびる
胆: きも
鍛: きたえる
団: かたまり、まるい
弾: ひく、はずむ、たま、はじく、はじける、ただす、はじきゆみ
断: たつ、ことわる、さだめる
暖: あたたか、あたたかい、あたたまる、あたためる
男: おとこ、お
値: ね、あたい
知: しる、しらせる
恥: はじる、はじ、はじらう、はずかしい
池: いけ
痴: しれる、おろか
稚: いとけない、おさない、おくて、おでる
置: おく
致: いたす
遅: おくれる、おくらす、おそい
築: きずく
竹: たけ
蓄: たくわえる
着: きる、きせる、つく、つける
中: なか、うち、あたる
仲: なか
昼: ひる
柱: はしら
注: そそぐ、さす、つぐ
虫: むし
酎: かもす
鋳: いる
著: あらわす、いちじるしい
貯: ためる、たくわえる
丁: ひのと
兆: きざす、きざし
帳: とばり
庁: やくしょ
弔: とむらう、とぶらう
張: はる
彫: ほる
徴: しるし
懲: こりる、こらす、こらしめる
挑: いどむ
朝: あさ
潮: しお、うしお
町: まち
眺: ながめる
聴: きく、ゆるす
腸: はらわた、わた
調: しらべる、しらべ、ととのう、ととのえる
超: こえる、こす
跳: はねる、とぶ
長: ながい、おさ
頂: いただく、いただき
鳥: とり
勅: いましめる、みことのり
捗: はかどる
直: ただちに、なおす、なおる、なおき、すぐ
沈: しずむ、しずめる
珍: めずらしい、たから
鎮: しずめる、しずまる、おさえ
陳: ひねる
津: つ
墜: おちる、おつ
椎: つち、うつ
追: おう
痛: いたい、いたむ、いたましい、いためる
通: とおる、とおり、とおす、とおし、かよう
塚: つか
漬: つける、つかる
潰: つぶす、つぶれる、ついえる
坪: つぼ
爪: つめ
釣: つる、つり
鶴: つる
低: ひくい、ひくめる、ひくまる
停: とめる、とまる
貞: ただしい、さだ
堤: つつみ
定: さだめる、さだまる、さだか
帝: みかど
底: そこ
庭: にわ
弟: おとうと
提: さげる
程: ほど
締: しまる、しまり、しめる
訂: ただす
諦: あきらめる、つまびらか、まこと
逓: かわる、たがいに
邸: やしき
泥: どろ、なずむ
摘: つむ
敵: かたき、あだ、かなう
滴: しずく、したたる
的: まと
笛: ふえ
適: かなう
溺: いばり、おぼれる
哲: さとい、あきらか
鉄: くろがね
典: ふみ、のり
天: あまつ、あめ
店: みせ、たな
添: そえる、そう
貼: はる、つく
転: ころがる、ころげる、ころがす、ころぶ、まろぶ、うたた、うつる、くるめく
点: つける、つく、たてる、さす、とぼす、ともす、ぼち
伝: つたわる、つたえる、つたう、つだう、つて
殿: との
田: た
吐: はく、つく
塗: ぬる、ぬり、まみれる
妬: ねたむ、そねむ、つもる、ふさぐ
徒: いたずら、あだ
渡: わたる、わたす
登: のぼる、あがる
賭: かける、かけ
途: みち
都: みやこ
努: つとめる
度: たび
土: つち
奴: やつ、やっこ
怒: いかる、おこる
倒: たおれる、たおす、さかさま、さかさ、さかしま
党: なかま、むら
冬: ふゆ
凍: こおる、こごえる、こごる、いてる、しみる
刀: かたな、そり
唐: から
島: しま
悼: いたむ
投: なげる
東: ひがし
桃: もも
棟: むね
盗: ぬすむ、ぬすみ
湯: ゆ
灯: ひ、ともしび、ともす、あかり
当: あたる、あたり、あてる、あて、まさに、まさにべし
等: ひとしい、など
答: こたえる、こたえ
筒: つつ
統: すべる、ほびる
到: いたる
藤: ふじ
討: うつ
豆: まめ
踏: ふむ、ふまえる
逃: にげる、にがす、のがす、のがれる
透: すく、すかす、すける、とうる、とうす
陶: すえ
頭: あたま、かしら、かぶり
騰: あがる、のぼる
闘: たたかう、あらそう
働: はたらく
動: うごく、うごかす
同: おなじ
導: みちびく
憧: あこがれる
洞: ほら
瞳: ひとみ
童: わらべ
道: みち、いう
銅: あかがね
峠: とうげ
匿: かくまう
得: える、うる
篤: あつい
独: ひとり
読: よむ
栃: とち
凸: でこ
突: つく
届: とどける、とどく
屯: たむろ
豚: ぶた
頓: にわかに、とんと、つまずく、とみに、ぬかずく
曇: くもる
鈍: にぶい、にぶる、なまる、なまくら
奈: いかん、からなし
那: なに、なんぞ、いかん
内: うち
謎: なぞ
鍋: なべ
縄: なわ、ただす
南: みなみ
軟: やわらか、やわらかい
難: かたい、むずかしい、むづかしい、むつかしい
二: ふた、ふたつ、ふたたび
尼: あま
弐: ふたつ、そえ
匂: におう、におい、におわせる
肉: しし
虹: にじ
日: ひ
乳: ちち、ち
入: いる、いれる、はいる
如: ごとし
尿: ゆばり、いばり、しと
任: まかせる、まかす
妊: はらむ、みごもる
忍: しのぶ、しのばせる
認: みとめる、したためる
寧: むしろ
猫: ねこ
熱: あつい
年: とし
捻: ねじる、ねじる、ひねくる、ひねる
燃: もえる、もやす、もす
粘: ねばる
悩: なやむ、なやます、なやましい、なやみ
濃: こい
納: おさめる、おさまる
能: よく、あたう
脳: のうずる
覇: はたがしら
波: なみ
破: やぶる、やぶれる、われる
婆: ばば、ばあ
罵: ののしる
馬: うま、ま
廃: すたれる、すたる
拝: おがむ、おろがむ
敗: やぶれる
杯: さかずき
背: せ、せい、そむく、そむける
輩: やから、やかい、ともがら
配: くばる
培: つちかう
媒: なこうど
梅: うめ
買: かう
売: うる、うれる
剥: へぐ、へずる、むく、むける、はがれる、はぐ、はげる、はがす
泊: とまる、とめる
白: しろ、しろい
薄: うすい、うすめる、うすまる、うすらぐ、うすれる、すすき
迫: せまる
爆: はぜる
縛: しばる
麦: むぎ
箱: はこ
箸: はし
肌: はだ
畑: はた、はたけ
八: や、やつ、やっつ、よう
発: たつ、あばく、おこる、つかわす、はなつ
髪: かみ
伐: きる、そむく、うつ
罰: ばっする
抜: ぬく、ぬき、ぬける、ぬかす、ぬかる
伴: ともなう
判: わかる
半: なかば
反: そる、そらす、かえす、かえる
帆: ほ
斑: ふ、まだら
板: いた
氾: ひろがる
汎: ただよう、ひろい
犯: おかす
畔: あぜ、くろ、ほとり
繁: しげる、しげく
煩: わずらう、わずらわす、うるさがる、うるさい
頒: わかつ、わける
飯: めし
番: つがい
蛮: えびす
卑: いやしい、いやしむ、いやしめる
否: いな、いや
妃: きさき
彼: かれ、かの、かの
悲: かなしい、かなしむ
扉: とびら
比: くらべる
疲: つかれる、つからす
皮: かわ
碑: いしぶみ
秘: ひめる、ひそか、かくす
罷: やめる
肥: こえる、こえ、こやす、こやし、ふとる
被: こうむる、おおう、かぶる、かぶせる
費: ついやす、ついえる
避: さける、よける
非: あらず
飛: とぶ、とばす
備: そなえる、そなわる、つぶさに
尾: お
微: かすか
眉: まゆ
美: うつくしい
鼻: はな
匹: ひき
膝: ひざ
肘: ひじ
必: かならず
筆: ふで
姫: ひめ
媛: ひめ
百: もも
俵: たわら
標: しるべ、しるし
氷: こおり、ひ、こおる
漂: ただよう
表: おもて、あらわす、あらわれる、あらわす
描: えがく、かく
病: やむ、やまい
苗: なえ
品: しな
浜: はま
貧: まずしい
頻: しきりに
敏: さとい
瓶: かめ、へい
付: つける、つけ、つく、つき
夫: おっと、それ
婦: よめ
富: とむ、とみ
布: ぬの、しく、きれ
怖: こわい、こわがる、おじる、おそれる
扶: たすける
敷: しく
普: あまねく、あまねし
浮: うく、うかれる、うかぶ、うかべる
父: ちち
腐: くさる、くされる、くされ、くさらす、くさす
膚: はだ
負: まける、まかす、おう
赴: おもむく
附: つける、つく
侮: あなどる、あなずる
武: たけ、たけし
舞: まう、まい
風: かぜ
伏: ふせる、ふす
復: また
幅: はば
腹: はら
覆: おおう、くつがえす、くつがえる
払: はらう
沸: わく、わかす
仏: ほとけ
物: もの
分: わける、わけ、わかれる、わかる、わかつ
噴: ふく
憤: いきどおる
奮: ふるう
粉: デシメートル、こ、こな
紛: まぎれる、まぎらす、まぎらわす、まぎらわしい
文: ふみ、あや
聞: きく、きこえる
丙: ひのえ
併: あわせる
兵: つわもの
幣: ぬさ
平: たいら、たいらげる、ひら
柄: がら、え、つか
並: なみ、なみ、ならべる、ならぶ、ならびに
蔽: おおう、おおい
閉: とじる、とざす、しめる、しまる、たてる
米: こめ、よね
壁: かべ
癖: くせ、くせに
別: わかれる、わける
蔑: ないがしろ、なみする、くらい、さげすむ
偏: かたよる
変: かわる、かわり、かえる
片: かた
編: あむ
辺: あたり、ほとり
返: かえす、かえる
遍: あまねく
便: たより
勉: つとめる
弁: かんむり、わきまえる、わける、はなびら、あらそう
保: たもつ
捕: とらえる、とらわれる、とる、とらえる、とらわれる、つかまえる、つかまる
歩: あるく、あゆむ
補: おぎなう
穂: ほ
募: つのる
墓: はか
慕: したう
暮: くれる、くらす
母: はは、も
倣: ならう
包: つつむ、くるむ
報: むくいる
奉: たてまつる、まつる、ほうずる
宝: たから
峰: みね、ね
崩: くずれる、くずす
抱: だく、いだく、かかえる
放: はなす、はなつ、はなれる、こく、ほうる
方: かた
法: のり
泡: あわ
縫: ぬう
芳: かんばしい
蜂: はち
褒: ほめる
訪: おとずれる、たずねる、とう
豊: ゆたか、とよ
邦: くに
飽: あきる、あかす、あく
乏: とぼしい、ともしい
亡: ない、ほろびる、ほろぶ、ほろぼす
傍: かたわら、わき、はた、そば
妨: さまたげる
帽: ずきん、おおう
忘: わすれる
忙: いそがしい、せわしい、おそれる、うれえるさま
房: ふさ
暴: あばく、あばれる
望: のぞむ、もち
某: それがし、なにがし
冒: おかす
紡: つむぐ
膨: ふくらむ、ふくれる
謀: はかる、たばかる、はかりごと
貌: かたち、かたどる
防: ふせぐ
北: きた
僕: しもべ
墨: すみ
朴: ほう、ほお、えのき
牧: まき
睦: むつまじい、むつむ、むつぶ
勃: おこる、にわかに
没: おぼれる、しずむ、ない
堀: ほり
奔: はしる
本: もと
翻: ひるがえる、ひるがえす
凡: およそ、おうよそ、すべて
摩: まする、さする、する
磨: みがく、する
麻: あさ
埋: うめる、うまる、うもれる、うずめる、うずまる、いける
妹: いもうと
昧: くらい、むさぼる
毎: ごと
幕: とばり
枕: まくら
又: また
末: すえ、うら、うれ
繭: まゆ、きぬ
万: よろず
満: みちる、みつ、みたす
漫: みだりに、そぞろ
味: あじ、あじわう
未: いまだ、まだ、ひつじ
岬: みさき
密: ひそか
脈: すじ
妙: たえ
民: たみ
眠: ねむる、ねむい
務: つとめる
夢: ゆめ、ゆめみる、くらい
無: ない
矛: ほこ
霧: きり
婿: むこ
娘: むすめ、こ
冥: くらい
名: な
命: いのち
明: あかり、あかるい、あかるむ、あからむ、あきらか、あける、あく、あくる、あかす
迷: まよう
鳴: なく、なる、ならす
滅: ほろびる、ほろぶ、ほろぼす
免: まぬかれる、まぬがれる
綿: わた
面: おも、おもて、つら
麺: むぎこ
茂: しげる
妄: みだりに
毛: け
盲: めくら
網: あみ
木: き
黙: だまる、もだす
目: め
餅: もち、もちい
戻: もどす、もどる
問: とう、とい、とん
門: かど、と
冶: いる
夜: よ、よる
野: の
弥: や、いや、いよいよ、わたる
矢: や
約: つづまる、つづめる、つづまやか
薬: くすり
訳: わけ
躍: おどる
柳: やなぎ
愉: たのしい、たのしむ
油: あぶら
癒: いえる、いやす、いやす
諭: さとす
唯: ただ
優: やさしい、すぐれる、まさる
勇: いさむ
友: とも
幽: ふかい、かすか、くらい、しろい
憂: うれえる、うれい、うい、うき
有: ある
湧: わく
猶: なお
由: よし、よる
誘: さそう、いざなう
遊: あそぶ、あそばす
雄: おす、おん
融: とける、とかす
夕: ゆう
予: あらかじめ
余: あまる、あまり、あます、あんまり
与: あたえる、あずかる、くみする、ともに
誉: ほまれ、ほめる
預: あずける、あずかる
幼: おさない
妖: あやしい、なまめく、わざわい
容: いれる
揚: あげる、あがる
揺: ゆれる、ゆる、ゆらぐ、ゆるぐ、ゆする、ゆさぶる、ゆすぶる、うごく
様: さま、さん
溶: とける、とかす、とく
用: もちいる
窯: かま
羊: ひつじ
葉: は
要: いる、かなめ
謡: うたい、うたう
踊: おどる
陽: ひ
養: やしなう
抑: おさえる
欲: ほっする、ほしい
沃: そそぐ
浴: あびる、あびせる
翼: つばさ
羅: うすもの
裸: はだか
来: くる、きたる、きたす、きたす、きたる、き、こ
頼: たのむ、たのもしい、たよる
雷: かみなり、いかずち、いかづち
絡: からむ、からまる
落: おちる、おち、おとす
乱: みだれる、みだる、みだす、みだ、おさめる、わたる
卵: たまご
嵐: あらし
欄: てすり
濫: みだりに、みだりがましい
藍: あい
覧: みる
利: きく
履: はく
梨: なし
理: ことわり
裏: うら
里: さと
離: はなれる、はなす
陸: おか
率: ひきいる
立: たつ、たてる
略: ほぼ、はぶく、おかす、おさめる、はかりごと、はかる
流: ながれる、ながれ、ながす
留: とめる、とまる、とどめる、とどまる、るうぶる
粒: つぶ
竜: たつ、いせ
侶: とも
慮: おもんぱくる、おもんぱかる
旅: たび
虜: とりこ、とりく
両: てる、ふたつ
涼: すずしい、すずむ、すずやか、うすい、ひやす、まことに
猟: かり、かる
瞭: あきらか
糧: かて
良: よい、いい
量: はかる
陵: みささぎ
領: えり
力: ちから
緑: みどり
林: はやし
臨: のぞむ
輪: わ
隣: となる、となり
塁: とりで
涙: なみだ
類: たぐい
例: たとえる
冷: つめたい、ひえる、ひや、ひややか、ひやす、ひやかす、さめる、さます
励: はげむ、はげます
鈴: すず
隷: したがう、しもべ
零: ぜろ、こぼす、こぼれる
霊: たま
麗: うるわしい、うららか
齢: よわい、とし
暦: こよみ
劣: おとる
烈: はげしい
裂: さく、さける
恋: こう、こい、こいしい
練: ねる、ねり
連: つらなる、つらねる、つれる
錬: ねる
呂: せぼね
炉: いろり
賂: まいない、まいなう
路: みち
露: つゆ
労: ろうする、いたわる、いたずき、ねぎら、つかれる、ねぎらう
弄: いじくる、ろうする、いじる、ひねくる、たわむれる、もてあそぶ
朗: ほがらか、あきらか
楼: たかどの
漏: もる、もれる、もらす
老: おいる、ふける
郎: おとこ
六: む、むつ、むっつ、むい
麓: ふもと
録: しるす、とる
論: あげつらう
和: やわらぐ、やわらげる、なごむ、なごやか、あえる
話: はなす、はなし
賄: まかなう
脇: わき、わけ
惑: まどう
枠: わく
湾: いりえ
腕: うで
丼: どんぶり
傲: おごる、あなどる
哺: はぐくむ、ふくむ
喩: たとえる、さとす
嗅: かぐ
嘲: あざける
毀: こぼつ、こわす、こぼれる、こわれる、そしる、やぶる
彙: はりねずみ
恣: ほしいまま
惧: おそれる
慄: ふるえる、おそれる、おののく
憬: あこがれる
拉: らっする、ひしぐ、くだく
摯: いたる
曖: くらい
鬱: うっする、ふさぐ、しげる
璧: たま
瘍: かさ
箋: ふだ
籠: かご、こめる、こもる、こむ
緻: こまかい
羞: はじる、すすめる、はずかしい
訃: しらせ
諧: かなう、やわらぐ
貪: むさぼる
踪: あと
辣: からい
錮: ふさぐ
塡: はまる、うずめる、はめる、ふさぐ
頰: ほお、ほほ
