一: 一
二: 二
三: 二一
四: 園儿
五: 五
六: 六
七: 七
八: 八
九: 九
十: 十
百: 百
千: ノ十
日: 日
月: 月
火: 火
水: 水
木: 木
金: 金
土: 土
下: 一卜
上: 卜一
左: 大工
右: 大口
大: 大
中: 中
小: 小
手: 手
足: 口疋
目: 目
耳: 耳
口: 口
人: 人
子: 子
女: 女
男: 田力
名: 夕口
年: 竹二
山: 山
川: 川
森: 木木木
林: 木木
田: 田
空: 六工
雨: 雨
天: 天
気: 气区
夕: 夕
花: 廿人匕
草: 廿日十
竹: 竹
犬: 犬
虫: 虫
貝: 貝
石: 石
王: 王
玉: 王丶
力: 力
糸: 糸
車: 車
音: 音
学: 小子
校: 木六区
先: 先
生: 生
字: 宀子
文: 文
本: 本
村: 木寸
町: 田丁
白: 丶日
赤: 土火
青: 青
円: 
正: 一止
早: 日十
入: 入
出: 山山
立: 立
休: 人木
見: 見
春: 三八日
夏: 一目夂
秋: 禾火
冬: 夂二
光: 小六
風: 几虫
晴: 日王月
雲: 雨厶
雪: 雨ヨ
朝: 十十月
昼: 尸日一
夜: 卜人夕
午: 午
明: 日月
星: 日生
野: 田土予
原: 日小
岩: 山一口
谷: 谷
海: 海
池: 水也
公: 八厶
園: 園
西: 西
南: 南
東: 東
北: 北
時: 日寺
分: 八刀
週: 道周
曜: 日ヨ隹
今: 今
元: 二儿
間: 門日
親: 立木見
母: 
兄: 兄
父: 八区
弟: 廿弓
姉: 女十巾
妹: 女十木
自: 丶目
友: 大又
体: 人木一
毛: 手山
頭: 豆頁
顔: 立三頁
声: 土尸
心: 心
首: 廿目
思: 田心
考: 土ノ弓
才: 才
言: 言
記: 言弓
話: 言舌
書: ヨ日
読: 言土六
聞: 門耳
語: 言五口
算: 竹目井
国: 園王
数: 米女攵
理: 王田土
科: 禾斗
社: 示土
会: 今厶
図: 園区
画: 一田山
工: 工
作: 人乍
歌: 可欠
絵: 糸人厶
楽: 冫日木
色: 色
紙: 糸氏
黄: 廿田八
黒: 田土火
形: 井三
点: 卜口火
丸: 九丶
線: 糸日水
合: 今口
直: 直
角: 弓用
計: 言十
何: 人可
答: 竹今口
電: 雨田心
教: 土子攵
知: 矢口
万: 一力
毎: 毎
回: 園口
番: ノ米田
半: 小干
当: 小ヨ
組: 糸目
交: 六区
通: 道用
道: 道
場: 土昜
地: 土也
方: 方
京: 京
市: 十巾
里: 田土
寺: 寺
店: 皮卜口
家: 宀豕
門: 門
室: 宀至
戸: 一尸
台: 厶口
汽: 水气
船: 舟八口
弓: 弓
矢: 矢
刀: 刀
馬: 馬
魚: 弓田火
牛: 牛
鳥: 鳥
鳴: 口鳥
羽: 羽
肉: 人人周
米: 米
麦: 王夂
茶: 廿人木
食: 食
活: 水舌
用: 用
前: 前
後: 後
内: 人周 
外: 夕卜
遠: 道園
近: 道斤
多: 夕夕
少: 少
古: 十口
新: 新
太: 大丶
細: 糸田
強: 弓厶虫
弱: 弓羽
長: 長
高: 高
広: 皮厶
同: 周一
歩: 止小
走: 走
行: 行
来: 十米
帰: 刀ヨ巾
止: 止
売: 土六
買: 皿貝
引: 弓中
切: 匕刀
悪: 一皿一心
安: 宀女
暗: 日音
医: 区矢
委: 禾女
意: 音心
育: 厶月
員: 口貝
院: 阝宀六
飲: 食欠
運: 道一車
泳: 水水
駅: 馬尸
央: 中大
横: 木廿田八
屋: 尸至
温: 水日皿
化: 人匕
荷: 廿人可
界: 田介
開: 門井
階: 阝比日
寒: 宀井冫
感: 戈口心
漢: 漢
館: 食宀呂
岸: 山干
起: 走弓
究: 六九
期: 貝月
客: 宀夂口
急: 弓ヨ心
級: 糸及
宮: 宀呂
球: 王戈水
去: 土厶
橋: 木竹大月
業: 廿廿二木
曲: 曲
局: 尸周
銀: 金食
区: 区
苦: 廿十口
係: 人糸
具: 目六
君: ヨ口
軽: 車又土
血: 丶皿
決: 水夬
研: 石井
県: 目示
庫: 皮車
湖: 水十口月
向: 周口
幸: 幸
港: 水井弓
号: 口一勹
根: 木食
祭: 癶示
皿: 皿
仕: 人土
死: 一夕匕
使: 人十史
始: 女厶口
指: 手匕日
歯: 止山米
詩: 言寺
次: 冫欠
事: 事
持: 手寺
式: 弋工
実: 宀土大
写: 一勹一
者: 者
主: 丶王
守: 宀寸
取: 耳又
酒: 水一金田
受: 月月又
州: 州
拾: 手人口
終: 糸夂冫
習: 羽日
集: 隹木
住: 人丶王
重: 重
宿: 宀人百
所: 尸斤
暑: 日土日
助: 月一大尸
昭: 日尸竹口
消: 水小月
商: 卜金月口
章: 音十
勝: 月火二力
乗: 禾井
植: 木十月一
申: 中田中
身: 耳ノ
神: 戈火中田中
真: 十月一金
深: 水月金木
進: 道隹
世: 心廿
昔: 井日
全: 人王
整: 木大一卜一
相: 木目
送: 道天
想: 木山心
息: 竹山心
速: 道束
族: 卜尸人人大
他: 人心木
打: 手丁
対: 文寸
待: 行寺
代: 人弋
第: 竹弓
炭: 山火
短: 矢豆
題: 日人一月金
談: 言火
着: 羊目
注: 水王
柱: 木王
丁: 丁
帳: 巾ヨ衣
調: 言周
追: 道呂
定: 十一卜人
庭: 戈弓大土
笛: 竹田
都: 土日阝
鉄: 金矢
転: 車二厶
度: 皮廿
投: 手竹弓水
豆: 豆
島: 鳥山
湯: 水昜
登: 癶豆
等: 竹土木戈
動: 竹土大尸
童: 卜井田土
農: 曲皮衣
波: 水皮
配: 一田尸山
畑: 火田
倍: 人卜井口
箱: 竹木月山
発: 癶井
反: 反
坂: 土反
板: 木反
皮: 皮
悲: 非心
美: 羊大
鼻: 目田井
筆: 竹ヨ
氷: 冫水
表: 王衣
秒: 禾小
病: 病
品: 品
負: 弓貝
部: 立口阝
服: 月卩又
福: 示口田
物: 牛勿
平: 平
返: 道反
勉: 色儿力
放: 方攵
味: 口十木
命: 今口卩
面: 園目
問: 門口
役: 行几又
薬: 廿冫日木
由: 丶田
油: 水丶田
有: 大月
遊: 道方子
予: 予
羊: 羊
洋: 水羊
葉: 廿心廿木
陽: 阝昜
様: 木羊水
落: 廿水夂口
流: 水厶川
旅: 方衣
両: 一周山
緑: 糸ヨ水
礼: 示心
列: 夕刀
練: 糸東
路: 口止夂口
和: 禾口
愛: 月月心水
案: 十女木
以: 以
衣: 衣
位: 人立
囲: 園井
胃: 田月
印: ヨ卩
英: 廿中大
栄: 小木
塩: 土口皿
億: 人音心
加: 力口
果: 田木
課: 言田木
芽: 廿手ノ
貨: 人心月山金
改: 尸山人大
械: 木戈井
害: 宀王口
街: 行土
各: 夂口
覚: 小見
完: 宀二儿
官: 宀呂
管: 竹宀呂
関: 門天
観: 牛隹見
季: 竹木弓木
願: 日小頁
希: 大大中月
紀: 糸弓
喜: 十豆口
旗: 方貝
器: 器
機: 木糸戈
議: 卜口井土戈
求: 戈水
泣: 水立
救: 戈水人大
給: 糸今口
挙: 
漁: 水弓田火
鏡: 金音儿
共: 廿八
協: 十力力
競: 卜山卜井山
極: 木一水一
訓: 言川
軍: 一車
郡: ヨ口阝
径: 行又土
型: 井刀土
景: 日口小
芸: 廿二厶
欠: 欠
結: 糸土口
建: 道ヨ
固: 園十口
健: 人道ヨ
験: 隹火今史
功: 工力
好: 女子
候: 人中矢
航: 舟卜几
康: 皮ヨ水
告: 牛口
差: 羊工
菜: 廿采
最: 最
材: 木才
昨: 日乍
札: 木乙
刷: 尸月中弓
察: 十月人火
参: 厶大三
殺: 区木几又
産: 立生
散: 廿月攵
残: 夕戈二
士: 十一
氏: 氏
史: 史
司: 司
試: 言弋工
児: 中日儿
治: 水厶口
辞: 舌立十
種: 禾重
失: 牛大
借: 人廿日
周: 周
祝: 示口儿
順: 川頁
初: 衣刀
松: 木八厶
笑: 竹夭
唱: 口日日
焼: 火十儿
象: 色豕
照: 日刀口火
賞: 小口貝
臣: 臣
省: 小目
信: 人言
成: 戈卩
清: 水王月
静: 
席: 皮廿巾
積: 禾王貝
折: 手斤
節: 竹食卩
説: 言口儿
浅: 水戈二
戦: 小十戈
選: 道弓井
然: 月犬火
争: 弓ヨ
倉: 今日口
巣: 小田木
束: 束
側: 人貝刀
続: 糸土六
卒: 卜人十
孫: 子糸
帯: 山巾
隊: 阝豕
達: 道土羊
単: 小田十
置: 田中十月一
仲: 人中
貯: 貝丁
兆: 儿冫
腸: 月昜
底: 皮氏
停: 人卜丁
低: 人氏
的: 日勹丶
典: 曲八
伝: 人二厶
徒: 行走
努: 女又力
灯: 火丁
堂: 小口土
働: 人重力
特: 牛寺
得: 行日寸
毒: 王毎
熱: 土戈火
敗: 貝攵
梅: 木毎
念: 今心
博: 十戈月戈
飯: 食反
飛: 飛
費: 儿弓貝
必: 心ノ
票: 皿示
標: 木皿示
不: 一小
夫: 十大
付: 人寸
府: 皮人寸
兵: 斤六
副: 一田刀
粉: 米八刀
別: 口力刀
辺: 道刀
変: 卜火夂
便: 人更
包: 勹弓
法: 水土厶
望: 卜月王
牧: 牛攵
末: 卜木
満: 
未: 十木
脈: 月斤卜
約: 糸勹
民: 口氏
無: 冊火
勇: 弓田刀
要: 一田女
養: 羊食
浴: 水谷
利: 禾刀
陸: 阝土儿土
良: 
料: 米斗
量: 日田土
輪: 車今冊
類: 米大頁
令: 今卩
歴: 木止
冷: 冫今卩
例: 人一弓弓
連: 道車
老: 土ノ匕
労: 
録: 金ヨ水
圧: 斤土
移: 禾夕
因: 園大
永: 丶水
営: 火呂
衛: 竹人木月弓 * 竹人木手弓
易: 日心竹竹
益: 廿八皿
液: 水卜人大
演: 水十一金
応: 
往: 竹人卜土
桜: 
恩: 園大心
可: 可
仮: 
価: 
河: 水可
過: 道咼
賀: 力口貝
快: 心夬
解: 弓用刀牛
格: 木夂口
確: 石宀隹
額: 宀口頁
刊: 干刀
眼: 目食
幹: 車今十
慣: 心田貝
基: 井金土
寄: 宀大可
規: 十大見
技: 手十又
義: 羊手戈
逆: 道廿山
久: 久
旧: 中日
居: 尸十口
許: 言午
境: 土立見
均: 土勹冫
句: 勹口
群: ヨ口羊
禁: 木示
経: 糸又土
潔: 水手竹火
件: 人牛
券: 火二刀
険: 阝今史
検: 木今史
限: 阝食
現: 王見
減: 水戈口
故: 十口攵
個: 
効: 六区力
厚: 日子
護: 卜口井人水
耕: 十禾井
鉱: 金皮厶
構: 木井再
興: 臼周六
講: 言井再
混: 水日比
査: 木月一
再: 再
災: 川火
妻: 十ヨ女
採: 手月木
際: 阝癶示
在: 大土
財: 貝丁
罪: 皿非
雑: 九木隹
酸: 一田戈金水
賛: 大貝
支: 十又
志: 土心
枝: 木十又
師: 呂巾
資: 冫欠貝
飼: 食可
識: 言立戈日
示: 示
似: 人以
質: 斤貝
舎: 人土口
謝: 言耳寸
授: 手月月水
修: 人攵三
述: 道木
術: 行木
準: 水隹十
序: 皮予
招: 手刀口
承: 子水
状: 丬犬
証: 言一止
条: 夂木
常: 小口巾
情: 心青
織: 糸立戈日
職: 耳立戈日
制: 牛巾刀
性: 心生
政: 一止攵
勢: 土戈大尸
精: 米王月
製: 牛巾刀衣
税: 禾口儿
責: 王貝
接: 手立女
設: 言几又
績: 糸王貝
舌: 舌
絶: 糸色
銭: 金戈二
祖: 示月一
素: 王糸
総: 糸八厶心
造: 道牛口
像: 人色豕
増: 土田日
則: 貝刀
測: 水貝刀
属: 
率: 卜戈人十
損: 手口貝
退: 卜日女
貸: 人弋貝
態: 戈心心
団: 園寸
断: 心米斤
築: 竹一弓木
張: 弓長
提: 手日一人
程: 竹木口竹土 * 竹木口一土
適: 卜卜金月
敵: 卜月人大
統: 女火卜戈山
銅: 金月一口
導: 卜山木戈
徳: 
独: 
任: 人竹土
燃: 火月大火
能: 戈月心心
破: 一口木竹水
犯: 大竹尸山
判: 火手中弓
版: 中中竹水
比: 心心
肥: 月日山
非: 非
備: 人廿用
俵: 人手一女
評: 卜口一火十
貧: 金尸竹金
布: 大巾
婦: 女尸一月
富: 十一口田
武: 戈止
復: 竹人人日水
複: 中人日水
仏: 人厶
編: 女火竹尸月
墓: 井日大土
弁: 厶井
保: 人口木
報: 幸卩又
豊: 曲豆
防: 阝方
貿: 厶刀貝
暴: 日井金水
務: 予攵力
夢: 井田中弓
迷: 道米
綿: 糸日巾
輸: 十十人一弓 * 十十人一女
余: 人一木
預: 弓弓一月金
容: 宀谷
略: 田夂口
留: 竹竹田
領: 人戈一月金
異: 田井
遺: 卜中一金
域: 土戈口
宇: 宀干
映: 日中大
延: 道一止
沿: 水八口
我: 手戈
灰: 反火
拡: 手皮厶
革: 廿中十
閣: 日弓竹水口
株: 木牛木
干: 干
割: 宀口刀
巻: 火二弓
看: 手目
簡: 竹門日
危: 弓卩
机: 木几
揮: 手車
貴: 中貝
疑: 心大弓戈人
吸: 口及
郷: 
供: 人井
胸: 月心山大
勤: 井一大尸
筋: 竹月大尸
系: ノ糸
敬: 井口人大
警: 井大卜一口
劇: 難卜人中弓 * 卜人中弓
激: 水竹尸大
穴: 宀八
絹: 女火口月
権: 
憲: 十手一心
厳: 
源: 水一竹火
己: 尸山
呼: 口竹火木
誤: 卜口口女大
后: 斤口
孝: 十ノ子
皇: 日王
紅: 糸工
降: 阝夂
鋼: 金月井山
刻: 厶人刀
穀: 土木竹弓水
骨: 月月月
困: 園木
砂: 石小
座: 皮人土
済: 水文月
裁: 十戈衣
策: 竹木巾
冊: 冊
蚕: 竹大中一戈
至: 一戈土
私: 竹木戈
姿: 戈人女 * 一人女
誌: 卜口土心
視: 示見
詞: 言司
磁: 一口井女戈
射: 身寸
捨: 手人土口
尺: 尺
若: 井大口
樹: 木土井戈
収: 
宗: 十示
就: 卜火戈大山
衆: 
従: 
縦: 
縮: 女火十人日
熟: 卜戈火
純: 女火心山
処: 
署: 皿土日
諸: 言土日
除: 阝人示
将: 
傷: 人人日竹
障: 弓中卜井十
城: 土戈尸
蒸: 井弓水火
仁: 人二
針: 金十
垂: 竹十井一
推: 手隹
寸: 寸
盛: 戈卩皿
聖: 耳口王
誠: 言戈尸
宣: 十一日一
専: 十田寸
泉: 日水
洗: 水先
染: 水弓木
善: 井土井口 * 井井口
奏: 手大竹大
窓: 六厶心
創: 人口中弓
装: 丬土衣
層: 尸金田日
操: 手口口木
蔵: 
臓: 
存: 大子
尊: 廿儿日寸
宅: 宀ノ匕
担: 手日一
誕: 言道一止
段: ヨ几又
探: 手六木
暖: 日月一水
値: 
宙: 十丶田
忠: 中心
著: 廿土ノ日
庁: 皮丁
頂: 丁頁
潮: 水十十月
賃: 人土目金
痛: 大弓戈月
展: 尸井衣
討: 言寸
党: 小兄
糖: 米ヨ口
届: 尸田
難: 漢隹
乳: 月子心
認: 言刀心
納: 女火人月
脳: 
派: 水斤卜
拝: 手王十
俳: 人非
背: 中心月
肺: 月巾
班: 王刀王
晩: 日色儿
否: 一火口
批: 手心心
秘: 竹木心竹
腹: 月人日水
奮: 大人土田
並: 立立
陛: 阝心心土
閉: 門才
片: 中中一中
補: 中戈十月
暮: 廿日大日
宝: 宀目丶
訪: 言方
亡: 卜心
忘: 卜心心
棒: 木手大手
枚: 木攵
幕: 井日大月
密: 十心竹山
盟: 日月皿
模: 木井日大
訳: 言尺
優: 人一目水
幼: 糸力
郵: ノノ阝
欲: 八口欠
翌: 勹冫立
乱: 舌心
卵: 卵
覧: 
裏: 車衣
律: 行ヨ
臨: 臣口
朗: 食月
論: 言人冊
