亜: 一皿一
哀: 卜口衣
挨: 手厶矢
曖: 日月月水 * 月山月月水
握: 手尸至
扱: 手弓竹水
宛: 宀夕卩
嵐: 山几虫
依: 人卜竹女
威: 戈竹一女
為: 月竹弓火 * 戈大弓火
畏: 田衣
尉: 尸火木戈
萎: 廿竹木女
偉: 人木一手
椅: 木大可
彙: 女一月田木
違: 卜木一手
維: 糸隹
慰: 尸戈心 * 難尸戈心
緯: 女火木一手
壱: 
逸: 卜弓日戈
茨: 廿戈一人 * 廿一一人
芋: 廿一木 * 難廿一木
咽: 口田大
姻: 女田大
淫: 水月竹土
陰: 阝中人戈戈
隠: 阝
韻: 立日口貝
唄: 口貝
鬱: 木木月山竹
畝: 卜田弓人
浦: 水十用
詠: 言丶水
影: 日京三
鋭: 金兄
疫: 病几又
悦: 心口儿
越: 走戈
謁: 卜口日心女
閲: 門兄
炎: 火火
怨: 弓山心
宴: 十日女
媛: 女月一水
援: 手月一水
煙: 火一田土 * 火田大
猿: 大竹土口女
鉛: 金八口
縁: 糸ヨ豕
艶: 
汚: 
凹: 尸尸山
押: 手田中
旺: 日一土
欧: 区欠
殴: 区几又
翁: 金戈尸一
奥: 
岡: 周廿山
憶: 心卜廿心
臆: 月卜廿心
虞: 卜心口一大 * 卜心口女大
乙: 弓山
俺: 人大中山
卸: 人一尸中
穏: 
佳: 人土土
苛: 廿丁口
架: 刀口木
華: 廿一廿十
菓: 廿田木
渦: 水咼
嫁: 女宀豕
暇: 日口尸水
禍: 示咼
靴: 廿十人心
寡: 十一金竹
箇: 竹田十口
稼: 竹木十一人
蚊: 虫文
牙: 手ノ
瓦: 一女弓戈
雅: 一竹人土
餓: 人戈竹手戈
介: 人儿
戒: 戈廿
怪: 心又土
拐: 手口刀
悔: 心毎
皆: 比日
塊: 土田儿厶
楷: 木比日
潰: 水中貝
壊: 
懐: 
諧: 言比日
劾: 厶人力
崖: 山一土土
涯: 水一土土
慨: 心日戈山
蓋: 廿土月廿 * 廿土戈廿
該: 卜口卜女人
概: 木日戈山
骸: 月月卜女人
垣: 土一日一
柿: 木卜中月
核: 木卜女人
殻: 
郭: 卜木弓中
較: 十十卜金大
隔: 弓中一口月
獲: 大竹廿人水
嚇: 口土金金
穫: 竹木廿人水
岳: 人一山
顎: 口尸一月金
掛: 手土土卜
潟: 水臼勿
括: 手舌
喝: 口日心女
渇: 
葛: 廿日心女
滑: 水月月月
褐: 中日心女
轄: 十十十手口
且: 月一
釜: 金大一土金
鎌: 金廿難金
刈: 大中弓
甘: 廿一
汗: 水一十
缶: 人十山
肝: 月一十
冠: 月一山戈
陥: 
乾: 十十人弓
勘: 廿女大尸
患: 中中心
貫: 田十月山金
喚: 口弓月大
堪: 土廿一女
換: 手弓月大
敢: 一十人大
棺: 木十口口
款: 土火弓人
閑: 日弓木
勧: 
寛: 
歓: 
監: 尸戈月廿 * 尸一月廿
緩: 女火月一水
憾: 心戈口心
還: 卜田中女
環: 一土田中女
韓: 十十木一手
艦: 竹卜尸戈廿 * 竹卜尸一廿
鑑: 金尸戈廿 * 金尸一廿
含: 今口
玩: 一土一一山
頑: 一山一月金
企: 人止
伎: 人十又
岐: 山十又
忌: 弓心
奇: 大可
祈: 示斤
軌: 車力
既: 食立儿
飢: 食几
鬼: 竹山戈
亀: 
幾: 糸戈人
棋: 木廿一金
棄: 卜戈廿木
毀: 竹土竹弓水 * 竹一竹弓水
畿: 糸戈田
輝: 火山月十十
騎: 尸火大一口
宜: 十月一
偽: 人月竹火 * 人戈大火
欺: 廿金弓人
儀: 人廿土戈
戯: 
擬: 手心大人
犠: 
菊: 廿勹米
吉: 土口
喫: 口王刀大
詰: 言土口
却: 土厶卩
脚: 月土厶卩
虐: 卜心尸一
及: 及
丘: 斤一
朽: 木一勹
臼: 臼
糾: 糸厶
嗅: 口竹山大
窮: 十金竹竹弓
巨: 巨
拒: 手巨
拠: 
虚: 
距: 口一尸尸
御: 竹人人一中
凶: 山区
叫: 口厶
狂: 犬王
享: 卜口弓木
況: 水口儿
峡: 山立大
挟: 手立大
狭: 犬立大
恐: 一弓心 * 難一弓心
恭: 廿金心
脅: 月大尸尸 * 大尸大尸月
矯: 人大竹大月
響: 口竹月口 * 女中卜廿日
驚: 廿大尸手火
仰: 人竹女中
暁: 
凝: 戈一心大人
巾: 中月
斤: 竹一中
菌: 廿田竹木
琴: 一土人戈弓
僅: 人廿中一
緊: 尸水女戈火
錦: 金竹日月
謹: 卜口廿中一
襟: 中木木火
吟: 口人戈弓
駆: 
惧: 
愚: 田月心
偶: 人田中月
遇: 卜田中月
隅: 弓中田中月
串: 中中
屈: 尸山山
掘: 手尸山山
窟: 十金尸山山
熊: 戈心火
繰: 女火口口木
勲: 
薫: 
刑: 井刀
茎: 
契: 手竹大
恵: 十田心
啓: 
掲: 
渓: 
蛍: 小中厶
傾: 人心一金
携: 
継: 
詣: 難卜口心日 * 卜口心日
慶: 戈難水
憬: 心日卜火
稽: 竹木戈山日
憩: 竹廿心 * 竹山心 * 難竹山心
鶏: 
迎: 卜竹女中
鯨: 弓火卜口火
隙: 阝小日小
撃: 
桁: 木行
傑: 人弓手木
肩: 尸月
倹: 
兼: 廿難金
剣: 
拳: 火手手
軒: 十十一十
圏: 
堅: 尸水土
嫌: 女廿難金
献: 
遣: 卜中一口
賢: 尸水月山金
謙: 卜口廿難金
鍵: 金弓大手
繭: 廿月中戈
顕: 
懸: 月火心
幻: 女戈尸
玄: 卜女戈
弦: 弓卜女戈
舷: 竹卜卜女戈
股: 月竹弓水
虎: 卜心竹弓 * 卜心竹山
孤: 弓木竹女人
弧: 弓竹女人
枯: 木十口
雇: 竹尸人土
誇: 卜口大一尸
鼓: 土廿十水
錮: 金田十口
顧: 竹土一月金
互: 一女弓一
呉: 
娯: 
悟: 心五口
碁: 廿金一口
勾: 勹厶
孔: 弓木山
巧: 工一勹
甲: 田中
江: 水工
坑: 土卜几
抗: 手卜竹弓
攻: 工攵
更: 更
拘: 手心口
肯: 卜一月
侯: 人弓一大
恒: 心一日一
洪: 水廿金
荒: 廿亡川
郊: 六区阝
香: 禾日
貢: 工貝
控: 手十金一
梗: 木一中大
喉: 口人弓大
慌: 心廿卜山
硬: 一口一中大
絞: 女火卜金大
項: 工頁
溝: 水廿廿月
綱: 女火月廿山
酵: 一田十大木
稿: 竹木卜口月
衡: 竹人弓大弓
購: 月金廿廿月
乞: 一弓
拷: 手十大尸
剛: 月山中弓
傲: 人土尸大
豪: 卜口豕
克: 十口儿
酷: 一田竹土口
獄: 大竹卜口大
駒: 馬勹口
込: 道入
頃: 匕頁
昆: 日比
恨: 心食
婚: 女氏日
痕: 病食
紺: 糸廿一
魂: 一戈竹山戈
墾: 月女土
懇: 月女心
佐: 人大一
沙: 水火竹
唆: 口戈金水
詐: 言乍
鎖: 金火月金
挫: 手人人土
采: 采
砕: 
宰: 十卜廿十
栽: 十戈木
彩: 采三
斎: 
債: 人手一金
催: 人山隹
塞: 十廿金土
歳: 
載: 十戈十田十
埼: 土大一口
剤: 文月刀
崎: 山大口
削: 小月刀
柵: 木冊
索: 十月女戈火
酢: 一田人尸
搾: 手十金尸
錯: 金廿日
咲: 口一大
刹: 
拶: 手山夕
撮: 手日耳又
擦: 手十月火
桟: 
惨: 
傘: 人人人十
斬: 車斤
暫: 車斤日
旨: 匕日
伺: 人尸一口
刺: 木巾刀
祉: 戈火卜中一
肢: 月十水
施: 卜尸人心木
恣: 戈人心 * 一人心
脂: 月匕日
紫: 卜心女戈火
嗣: 口月尸一口
雌: 卜一心人土
摯: 土戈手
賜: 月金日心竹
諮: 卜口戈人口 * 卜口一人口
侍: 人土木戈
滋: 水廿女戈
慈: 廿女戈心
餌: 人戈尸十
璽: 一月一土戈
鹿: 戈難心
軸: 十十中田
?: 
?: 
疾: 大人大
執: 土十大弓戈
湿: 
嫉: 女大人大
漆: 水木人水
芝: 廿戈弓人
赦: 土金人大
斜: 人木卜十
煮: 十日火
遮: 卜戈廿火
邪: 手ノ阝
蛇: 中戈十心
酌: 一田心戈 * 一田心一
釈: 
爵: 月田中戈
寂: 十卜火水
朱: 竹十木
狩: 大竹十木戈
殊: 一弓竹十木
珠: 一土竹十木
腫: 月竹十土
趣: 土人尸十水
寿: 
呪: 
需: 一月一月中
儒: 人一月月
囚: 田人
舟: 竹月卜戈
秀: 竹木弓竹尸
臭: 目大
袖: 中中田
羞: 廿手弓土
愁: 竹火心
酬: 一田戈中中 * 一田一中中
醜: 一田竹山戈
蹴: 口一卜火山
襲: 卜心卜竹女
汁: 水十
充: 卜戈竹山
柔: 弓竹木
渋: 
銃: 金卜戈山 * 難金卜戈山
獣: 
叔: 卜火水
淑: 水卜火水
粛: 
塾: 卜戈土
俊: 人戈金水
瞬: 月山月月手
旬: 心日
巡: 卜女女女
盾: 竹十月山
准: 戈一人土
殉: 一弓心日
循: 竹人竹十山
潤: 水日弓土
遵: 卜廿田戈
庶: 戈廿火
緒: 女火十大日
如: 女口
叙: 
徐: 竹人人一木
升: 竹廿
召: 尸竹口
匠: 尸竹一中
床: 戈木 * 女一木
抄: 手火竹
肖: 火月
尚: 火月口
昇: 日竹廿
沼: 水尸竹口
宵: 十火月
症: 大一卜一
祥: 戈火廿手
称: 
渉: 
紹: 女火尸竹口
訟: 卜口金戈
掌: 火月口手
晶: 日日日
焦: 人土火
硝: 一口火月
粧: 火木戈土
詔: 卜口尸竹口
奨: 
詳: 卜口廿手
彰: 卜十竹竹竹
憧: 心卜廿土
衝: 竹人竹土弓
償: 人火月金
礁: 一口人土火
鐘: 金卜廿土
丈: 十大
冗: 月竹弓 * 十竹弓 * 難月竹弓
浄: 
剰: 
畳: 
縄: 
壌: 
嬢: 
錠: 金十一人
譲: 
醸: 
拭: 手戈心一
殖: 一弓十月一
飾: 人戈人中月
触: 弓月中一戈
嘱: 
辱: 一女木戈
尻: 尸大弓
伸: 人中田中
芯: 廿心
辛: 卜廿十
侵: 人尸一水
津: 水中手
唇: 一女口
娠: 女一一女
振: 手一一女
浸: 水尸一水
紳: 女火中田中
診: 卜口人竹竹
寝: 
慎: 心十月金
審: 十竹木田
震: 一月一一女
薪: 廿卜木中
刃: 刀丶
尽: 
迅: 卜弓十
甚: 廿一一女
陣: 弓中十田十
尋: 尸一一口戈
腎: 尸水月
須: 三頁
吹: 口欠
炊: 火欠
帥: 呂巾
粋: 米九十
衰: 卜田一女
酔: 
遂: 卜廿心人
睡: 月山竹十一
穂: 
随: 
髄: 
枢: 
崇: 山十一火
据: 手尸十口
杉: 木竹竹竹
裾: 中尸十口
瀬: 
是: 日一卜人
井: 廿廿
姓: 女竹手一
征: 竹人一卜一
斉: 
牲: 竹手竹手一
凄: 戈一十中女
逝: 卜手竹中
婿: 土弓人月 * 女弓人月
誓: 手中卜一口
請: 卜口手一月
醒: 一田日竹一
斥: 竹一卜
析: 木竹一中
脊: 火金月
隻: 人土水 * 難人土水
惜: 心廿日
戚: 戈竹卜一火
跡: 口一卜中金 * 卜卜中金
籍: 竹手木日
拙: 手山山
窃: 
摂: 
仙: 人山
占: 卜口
扇: 竹尸尸一一
栓: 木人一土
旋: 卜尸人弓人
煎: 廿月弓火
羨: 廿土水弓人
腺: 月竹日水
詮: 卜口人一土
践: 
箋: 竹戈戈
潜: 水大日
遷: 卜一田山
薦: 廿戈難火
繊: 
鮮: 弓火廿手
禅: 
漸: 水十十中
膳: 月廿土口
繕: 女火廿土口 * 女火廿廿口
狙: 大竹月一
阻: 弓中月一
租: 竹木月一
措: 手廿日
粗: 火木月一
疎: 
訴: 卜口竹一卜
塑: 廿月土
遡: 
礎: 一口木木人
双: 
壮: 
荘: 
捜: 
挿: 
桑: 水水水木
掃: 手尸一月
曹: 廿田日
曽: 
爽: 大大大大
喪: 土口口女
痩: 
葬: 廿一心廿
僧: 人金田日
遭: 卜廿田日
槽: 木廿田日
踪: 
燥: 火口口木
霜: 一月木月山
騒: 
藻: 廿水口木
憎: 心金田日
贈: 月金金田日
即: 日戈尸中
促: 人口卜人
捉: 手口卜人
俗: 人金人口
賊: 月金戈十
遜: 卜弓木火
汰: 水大戈
妥: 月女
唾: 口竹十一
堕: 
惰: 心大一月
駄: 
耐: 一月木戈
怠: 戈口心 * 難戈口心
胎: 月戈口
泰: 手大水
堆: 土人土
袋: 人心卜竹女
逮: 卜中水
替: 手人日
滞: 
戴: 十戈田廿金
滝: 
択: 
沢: 
卓: 卜日十
拓: 手一口
託: 卜口竹心
濯: 水尸一土
諾: 卜口廿大口
濁: 水田中戈
但: 人日一
脱: 
奪: 大人土戈
棚: 木月月
誰: 卜口人土
丹: 月卜
旦: 日一
胆: 
淡: 水火火
嘆: 口廿中人
端: 卜廿山一月
綻: 女火十一人
鍛: 金竹十水
弾: 
壇: 土卜田一
恥: 尸十心 * 尸十卜中一
致: 一土竹水 * 一土人大
遅: 
痴: 大人大口
稚: 竹木人土
緻: 女火一土水 * 女火一土大
畜: 卜女戈田
逐: 卜一尸人
蓄: 廿卜女田
秩: 竹木竹手人
窒: 十金一戈土
嫡: 女卜金月
沖: 水中 * 戈一中
抽: 手中田
衷: 十中竹女 * 卜中竹女
酎: 一田木戈
鋳: 
駐: 尸火卜土
弔: 弓中 * 難弓中
挑: 手中一人
彫: 月口竹竹竹
眺: 月山中一人
釣: 金心戈
貼: 月金卜口
超: 土人弓口 * 土人尸竹口
跳: 口一中一人
徴: 
嘲: 口十十月
澄: 水弓人廿
聴: 
懲: 竹大心 * 難竹大心
勅: 
捗: 手卜中竹
沈: 水中月山
珍: 一土人竹竹
朕: 月廿大
陳: 弓中木田
鎮: 金十月金
椎: 木人土
墜: 弓人土
塚: 月一尸人 * 土月一人 * 難月一尸人
漬: 水手一金
坪: 土一火十
爪: 竹中人
鶴: 十土竹日火 * 人土竹日火
呈: 口竹土 * 口一土
廷: 弓大竹土
抵: 手竹心一
邸: 竹一弓中 * 難竹一弓中
亭: 卜口月弓
貞: 卜月山金
帝: 卜月中月
訂: 卜口一弓
逓: 
偵: 人卜月金
堤: 土日一人
艇: 竹卜弓大土
締: 女火卜月月
諦: 卜口卜月月
泥: 水尸心
摘: 手卜金月
滴: 水卜金月
溺: 水弓一一
迭: 卜竹手人
哲: 手中口
徹: 竹人卜月大
撤: 手卜月大
添: 水夭火
塡: 
殿: 尸金竹弓水
斗: 斗
吐: 口土
妬: 女石
途: 道人示
渡: 水皮廿又
塗: 水木土
賭: 月金十大日
奴: 女水
怒: 女水心
到: 至刀
逃: 卜中一人
倒: 人一土弓
凍: 戈一木田
唐: 戈中口
桃: 木中一人
透: 卜竹木尸
悼: 心卜日十
盗: 
陶: 弓中心人山
塔: 土廿人口
搭: 手廿人口
棟: 木木田
痘: 大一口廿
筒: 竹月一口
稲: 
踏: 口一水日
謄: 月火手口
藤: 廿月火水
闘: 
騰: 月火手火
洞: 水月一口
胴: 月月一口
瞳: 月山卜廿土
峠: 
匿: 尸廿大口
督: 卜水月山
篤: 竹尸手火
栃: 
凸: 月尸尸
突: 十金戈大
屯: 心山
豚: 月一尸人
頓: 心山一月金
貪: 人戈弓金
鈍: 金心山
曇: 日一月戈
丼: 廿廿戈
那: 尸手弓中
奈: 大一一火
梨: 竹弓木 * 難竹弓木
謎: 卜口卜火木
鍋: 金月月口
軟: 十十一月大 * 十十弓人
尼: 尸心
弐: 
匂: 
虹: 中戈一
尿: 尸水
妊: 女竹土 * 女人竹土
忍: 尸戈心
寧: 十心月弓
捻: 手人戈心
粘: 火木卜口
悩: 
濃: 水廿田女
把: 手日山
覇: 
婆: 水水女
罵: 田中尸手火
杯: 木一火
排: 手中一卜
廃: 
輩: 中卜十田十
培: 土卜廿口
陪: 弓中卜廿口
媒: 女廿一木
賠: 月金卜廿口
伯: 人竹日
拍: 手竹日
泊: 水竹日
迫: 弓大竹日 * 卜竹日
剝: 女水中弓
舶: 竹卜竹日
薄: 廿水戈戈
漠: 水廿日大
縛: 女火戈月戈
爆: 火日廿水
箸: 竹月一尸 * 竹十大日
肌: 月竹弓
鉢: 
髪: 
伐: 人戈
抜: 手大又
罰: 皿言刀
閥: 日弓人戈
氾: 水卩
帆: 巾几丶
汎: 水几丶
伴: 人火手
阪: 土竹水 * 弓中竹水
畔: 田火手
般: 竹卜竹弓水
販: 貝反
斑: 一土卜大土
搬: 手竹卜水
煩: 火頁
頒: 八刀頁
範: 竹十十山
繁: 人大女戈火
藩: 廿水竹田
蛮: 
盤: 竹水月廿
妃: 女弓
彼: 行皮
披: 手皮
卑: 竹田竹十
疲: 病皮
被: 衣皮
扉: 竹尸中一卜
碑: 一口竹田十
罷: 田中戈月心
避: 卜尸口十
尾: 尸竹手山
眉: 日竹月山
微: 竹人山山大
膝: 月木人水
肘: 月丁
匹: 区儿
泌: 水心ノ
姫: 
漂: 水一田火
苗: 廿田
描: 手廿田
猫: 犬廿田
浜: 水斤六
賓: 十一竹金
頻: 卜竹一月金
敏: 毎攵
瓶: 廿廿一女弓 * 卜十卜十弓
扶: 手十大
怖: 心大巾
阜: 呂十
附: 弓中人木戈
訃: 卜口卜
赴: 土人卜
浮: 水月弓木
符: 竹人木戈
普: 立立日
腐: 戈人戈月
敷: 戈尸人大
膚: 卜心田月
賦: 月金一心一
譜: 卜口廿金日 * 卜口廿一日
侮: 人毎
舞: 冊夕
封: 土土丁
伏: 人犬
幅: 巾口田
覆: 一田竹人水
払: 手厶
沸: 水儿弓
紛: 糸八刀
雰: 一月金尸竹
噴: 口十廿金
墳: 土十廿金
憤: 心十廿金
丙: 一人月
併: 人廿廿
柄: 木一人月
塀: 
幣: 火大中月
弊: 火大廿
蔽: 廿火月大
餅: 人戈廿廿
壁: 尸十土
璧: 尸十一土戈
癖: 大尸口十
蔑: 廿田中戈
偏: 人竹尸月
遍: 竹人竹尸月 * 卜竹尸月
哺: 口戈十月
捕: 手戈十月
舗: 
募: 廿日大尸
慕: 廿日大心
簿: 竹水戈戈
芳: 廿卜竹尸
邦: 竹手弓中 * 手十弓中
奉: 手大手
抱: 手心口山
泡: 水心口山
胞: 月心口山
俸: 人手大手
倣: 人卜尸大
峰: 山竹水十
砲: 一口心口山 * 一口尸火大
崩: 山月月
蜂: 中戈竹水十
飽: 人戈心口山
褒: 卜人木女
縫: 女火卜竹十
乏: 竹戈弓人
忙: 心卜女
坊: 土卜竹尸
妨: 女卜竹尸
房: 竹尸卜竹尸
肪: 月卜竹尸
某: 廿一木
冒: 日月山
剖: 卜口中弓
紡: 女火卜竹尸
傍: 人卜月尸
帽: 中月日月山
貌: 月竹竹日山 * 月竹竹難山
膨: 月土廿竹
謀: 卜口廿一木
頰: 大人一月金
朴: 木卜
睦: 月山土金土
僕: 人廿金人
墨: 田土火土
撲: 手廿金人
没: 
勃: 十木大尸
堀: 土尸山山
奔: 大十廿
翻: 竹田尸一一
凡: 竹弓戈
盆: 金尸竹廿
麻: 戈木木 * 戈十金金 * 廿戈木木 * 廿戈十金
摩: 戈金手 * 戈木手
磨: 戈金一口 * 戈木一口
魔: 戈金竹山戈 * 戈木竹山戈
昧: 日十木
埋: 土田土
膜: 月廿日大
枕: 木中月山
又: 又
抹: 手十木
慢: 心日皿又
漫: 水日皿又
魅: 竹戈十木
岬: 山田中
蜜: 十心竹戈
妙: 女火竹
眠: 月山口女心
矛: 弓戈弓竹
霧: 一月弓竹尸
娘: 女戈日女
冥: 月日卜金
銘: 金弓戈口
滅: 水戈竹火
免: 色儿
麺: 
茂: 廿戈竹
妄: 卜女女
盲: 卜女月山
耗: 手木竹手山
猛: 大竹弓木廿
網: 女火月廿女
黙: 
紋: 女火卜大
冶: 戈一戈口
弥: 
厄: 一尸山
躍: 口一尸一土
闇: 日弓卜廿日
喩: 
愉: 心人一弓
諭: 卜口人一弓 * 卜口人一女
癒: 大人一心
唯: 口人土
幽: 山女戈戈
悠: 人大心
湧: 水弓月尸
猶: 大竹廿金田
裕: 中金人口
雄: 大戈人土
誘: 卜口竹木尸
憂: 一月心竹水
融: 一月中一戈
与: 卜尸一
誉: 
妖: 女竹大
庸: 戈中月
揚: 手日一竹
揺: 
溶: 水十金口
腰: 月一田女
瘍: 大日一竹
踊: 口一弓戈月
窯: 十金月人山 * 十金人十山 * 十金廿土火
擁: 手卜女土
謡: 
抑: 手竹女中
沃: 水竹大
翼: 尸一田廿金
拉: 手卜廿
裸: 中田木
羅: 田中女火土
雷: 一月田
頼: 
絡: 女火竹水口
酪: 一田竹水口
辣: 卜十木中
濫: 水尸戈廿 * 水尸一廿
藍: 廿尸戈廿 * 廿尸一廿
欄: 木日弓田
吏: 十中大
痢: 大竹木弓
履: 尸竹人水
璃: 一土卜山月
離: 卜月人土
慄: 心一田木
柳: 木竹竹中
竜: 
粒: 火木卜廿
隆: 弓中竹水一 * 弓中人大一
硫: 一口卜戈山
侶: 人口竹口
虜: 卜心田大尸
慮: 卜心田心
了: 弓弓
涼: 水卜口火 * 戈一卜口火
猟: 
陵: 弓中土金水
僚: 人大金火
寮: 十大金火
療: 大大金火
瞭: 月山大金火
糧: 火木日一土
厘: 一田土
倫: 人人一月
隣: 
瑠: 
涙: 
累: 田女戈火
塁: 
励: 
戻: 
鈴: 金人戈戈
零: 一月人戈戈
霊: 
隷: 
齢: 
麗: 一一月月心
暦: 
劣: 火竹大尸
烈: 一弓火
裂: 一弓卜竹女
恋: 
廉: 戈廿難金 * 卜竹難金
錬: 
呂: 口竹口
炉: 
賂: 月金竹水口
露: 一月口一口
弄: 一土廿
郎: 戈戈弓中
浪: 水戈日女
廊: 戈戈戈中
楼: 
漏: 水尸一月
籠: 竹卜月心
麓: 木木戈難心
賄: 月金大月
脇: 
惑: 戈一心
枠: 
湾: 
腕: 月十弓山
